1111111111111
1001000000C01
1000011111001
1001000000C01
1001000000C01
1001000000C01
1001000000C01
1P0011000E011
1111111111111